{
  "name": "Village",
  "width": 20,
  "height": 20,
  "timerSeconds": 180,
  "musicFileLocation": "music.ogg",
  "musicBPM": 100,
  "heroSpawn": {
    "x": 3,
    "y": 3
  },
  "texturesFileLocation": "village_tileset.png",
  "portals": [
    {
      "x": 16,
      "y": 16
    }
  ],
  "enemies": [
    {
      "name": "lion",
      "x": 5,
      "y": 5
    },
    {
      "name": "lion",
      "x": 9,
      "y": 11
    },
    {
      "name": "lion",
      "x": 14,
      "y": 7
    },
    {
      "name": "spearman",
      "x": 7,
      "y": 14
    },
    {
      "name": "spearman",
      "x": 12,
      "y": 3
    },
    {
      "name": "spearman",
      "x": 17,
      "y": 12
    },
    {
      "name": "chest",
      "x": 4,
      "y": 9
    },
    {
      "name": "chest",
      "x": 15,
      "y": 18
    }
  ],
  "tiles": [
    [ 4, 4, 4, 4, 4, 4, 4, 4, 4, 4, 4, 4, 4, 4, 4, 4, 4, 4, 4, 4 ],
    [ 4, 0, 0, 0, 0, 0, 0, 0, 0, 4, 0, 0, 0, 0, 0, 0, 4, 0, 0, 4 ],
    [ 4, 0, 0, 0, 0, 0, 0, 0, 0, 4, 0, 0, 0, 0, 0, 0, 4, 0, 0, 4 ],
    [ 4, 0, 0, 0, 0, 0, 0, 0, 0, 4, 0, 0, 0, 0, 0, 0, 4, 0, 0, 4 ],
    [ 4, 0, 0, 0, 4, 4, 4, 0, 0, 4, 0, 0, 4, 4, 4, 4, 4, 0, 0, 4 ],
    [ 4, 0, 0, 0, 4, 0, 0, 0, 0, 0, 0, 0, 4, 0, 0, 0, 0, 0, 0, 4 ],
    [ 4, 0, 0, 0, 4, 0, 0, 0, 0, 0, 0, 0, 4, 0, 0, 0, 0, 0, 0, 4 ],
    [ 4, 0, 0, 0, 4, 0, 0, 4, 4, 4, 4, 0, 4, 0, 0, 0, 0, 0, 0, 4 ],
    [ 4, 0, 0, 0, 0, 0, 0, 4, 0, 0, 4, 0, 4, 0, 0, 4, 4, 4, 4, 4 ],
    [ 4, 4, 4, 4, 4, 0, 0, 4, 0, 0, 4, 0, 4, 0, 0, 4, 0, 0, 0, 4 ],
    [ 4, 0, 0, 0, 4, 0, 0, 4, 0, 0, 4, 0, 0, 0, 0, 4, 0, 0, 0, 4 ],
    [ 4, 0, 0, 0, 4, 0, 0, 0, 0, 0, 4, 4, 4, 0, 0, 4, 0, 0, 0, 4 ],
    [ 4, 0, 0, 0, 4, 4, 4, 0, 0, 0, 0, 0, 4, 0, 0, 4, 0, 0, 0, 4 ],
    [ 4, 0, 0, 0, 0, 0, 4, 0, 0, 0, 0, 0, 4, 0, 0, 4, 0, 0, 0, 4 ],
    [ 4, 0, 0, 0, 0, 0, 4, 4, 4, 4, 4, 4, 4, 0, 0, 4, 0, 0, 0, 4 ],
    [ 4, 0, 0, 0, 0, 0, 0, 0, 0, 0, 0, 0, 4, 0, 0, 0, 0, 0, 0, 4 ],
    [ 4, 0, 0, 0, 0, 0, 0, 0, 0, 0, 0, 0, 4, 0, 0, 0, 0, 0, 0, 4 ],
    [ 4, 0, 0, 0, 0, 0, 0, 0, 0, 0, 0, 0, 4, 0, 0, 0, 0, 0, 0, 4 ],
    [ 4, 0, 0, 0, 0, 0, 0, 0, 0, 0, 0, 0, 4, 0, 0, 0, 0, 0, 0, 4 ],
    [ 4, 4, 4, 4, 4, 4, 4, 4, 4, 4, 4, 4, 4, 4, 4, 4, 4, 4, 4, 4 ]
  ]
}