{
  "name": "Village",
  "width": 20,
  "height": 20,
  "timerSeconds": 180,
  "musicFileLocation": "music.ogg",
  "musicBPM": 100,
  "heroSpawn": {
    "x": 3,
    "y": 3
  },
  "texturesFileLocation": "village_tileset.png",
  "portals": [
    {
      "x": 16,
      "y": 16
    }
  ],
  "enemies": [
    {
      "name": "lion",
      "x": 4,
      "y": 5
    },
    {
      "name": "lion",
      "x": 12,
      "y": 4
    },
    {
      "name": "lion",
      "x": 7,
      "y": 13
    },
    {
      "name": "spearman",
      "x": 13,
      "y": 11
    },
    {
      "name": "spearman",
      "x": 15,
      "y": 8
    },
    {
      "name": "spearman",
      "x": 5,
      "y": 9
    },
    {
      "name": "chest",
      "x": 17,
      "y": 13
    },
    {
      "name": "chest",
      "x": 17,
      "y": 4
    }
  ],
  "tiles": [
    [ 4, 4, 4, 4, 4, 4, 4, 4, 4, 4, 4, 4, 4, 4, 4, 4, 4, 4, 4, 4 ],
    [ 4, 0, 0, 0, 0, 0, 0, 4, 0, 0, 0, 0, 0, 0, 0, 4, 0, 0, 0, 4 ],
    [ 4, 0, 0, 0, 0, 0, 0, 4, 0, 0, 0, 0, 0, 0, 0, 4, 0, 0, 0, 4 ],
    [ 4, 0, 0, 0, 0, 0, 0, 4, 0, 0, 0, 0, 0, 0, 0, 4, 0, 0, 0, 4 ],
    [ 4, 0, 0, 0, 0, 0, 0, 0, 0, 0, 0, 0, 0, 4, 4, 4, 0, 0, 0, 4 ],
    [ 4, 0, 0, 0, 0, 0, 0, 0, 0, 0, 0, 0, 0, 4, 0, 0, 0, 0, 0, 4 ],
    [ 4, 0, 0, 0, 0, 0, 0, 4, 4, 4, 4, 0, 0, 4, 0, 0, 0, 0, 0, 4 ],
    [ 4, 0, 0, 0, 0, 0, 0, 4, 0, 0, 4, 0, 0, 0, 0, 0, 0, 0, 0, 4 ],
    [ 4, 4, 4, 0, 4, 4, 4, 4, 0, 0, 4, 0, 4, 4, 4, 4, 4, 4, 4, 4 ],
    [ 4, 0, 0, 0, 0, 0, 0, 0, 0, 0, 0, 0, 4, 0, 0, 0, 0, 0, 0, 4 ],
    [ 4, 0, 0, 0, 0, 0, 0, 0, 0, 0, 0, 0, 4, 0, 0, 0, 0, 0, 0, 4 ],
    [ 4, 0, 0, 0, 0, 0, 4, 4, 4, 0, 0, 0, 4, 0, 0, 0, 0, 0, 0, 4 ],
    [ 4, 0, 0, 0, 0, 0, 4, 0, 0, 0, 0, 0, 0, 0, 0, 0, 0, 0, 0, 4 ],
    [ 4, 0, 0, 0, 0, 0, 4, 0, 0, 0, 0, 0, 0, 0, 0, 0, 0, 0, 0, 4 ],
    [ 4, 0, 0, 0, 0, 0, 4, 0, 0, 0, 0, 0, 0, 4, 4, 0, 0, 0, 0, 4 ],
    [ 4, 0, 0, 0, 0, 0, 4, 4, 4, 4, 4, 4, 4, 4, 0, 0, 0, 0, 0, 4 ],
    [ 4, 0, 0, 0, 0, 0, 0, 0, 0, 0, 0, 0, 0, 0, 0, 0, 0, 0, 0, 4 ],
    [ 4, 0, 0, 0, 0, 0, 0, 0, 0, 0, 0, 0, 0, 0, 0, 0, 0, 0, 0, 4 ],
    [ 4, 0, 0, 0, 0, 0, 0, 0, 0, 0, 0, 0, 0, 0, 0, 0, 0, 0, 0, 4 ],
    [ 4, 4, 4, 4, 4, 4, 4, 4, 4, 4, 4, 4, 4, 4, 4, 4, 4, 4, 4, 4 ]
  ]
}